################
|              |
|              |
|              |
|              |
|              |
|              |
|              |
|              |
|              |
|##############|
              

